00000000000000000000000000000000000000000000000000000000000000000000000000000000000000000000000000000000000000000000000000000000000000000000000000000000000000000000000000
00000000000000000000000000000000000000000000000000000000000000000000000000000000000000000000000000000000000000000000000000000000000000000000000000000000000000000000000000
00000000000000000000000000000000000000000000000000000000000000000000000000000000000000000000000000000000000000000000000000000000000000000000000000000000000000000000000000
00000000000000000000000000000000000000000000000000000000000000000000000000000000000000000000000000000000000000000000000000000000000000000000000000000000000000000000000000
0000000000000000000000000000000000000000000000000000000000000000000000000000000000000000000000000f000000000000000000000000000000000000000000000000000000000000000000000000
000000000000000000000000000000000000000000000000000000000000000e00000000000000000000000000000000000000000000000000000000000000000000000000000000000000000000000000000000000000000000000000000000
0000000000000000000000000000000000000000000000000000000000000000000000000000000000000000000000000000000000000000000000000000000000000000000000000000000000000000000000000000000000000000000000000
000000000000000000000000000000000000000000000000000000000000000000000000000000000000000000000000000000000000000000000000000000000000000000000000000000000000000000000000000
00000000000000000000000000000000000000000000000000000000000000000000000000000000000000000000000000000000000000000000000000000000000000000000000000000000000000000000000000
00000000000000000000000000000000000000f0000000000000000000000000000000000000000000000000c00d00000000000d000c00000000000000000000000000000000000000000000000000000000000000
00000000000000000000000000000000000000000000000000000000000006222500000800000800000800062222222222222222222250000000000000000000000000000000000000000000000000000000000000
00000000000000000000000000000000000000000000000000000000000004111300000000000000000000047777777777777777777731100000000000000000000000000000000000000000000000000000000000
000000e00000000000000000000000000000000000000000000000080000041d1300000000000000000800047777777777777777777731110000000000000000000000000000000000000000000000000000000000
00000000000000000000000000000000000000000000000000000000000004111300000000000000000000047777777777777777777731111000000000000000000000000000000000000000000000000000000000
0000000000000000d000000000000c00000000000000000008000000000009bbba000000000000000008000477777777777777777777311111c0000000000000000000000000000000000000000000000000000000
00000000000000006222225000011111000062222250000000000000000000000000c00000c00000000000047777777777777777777732222222222222222222250000000000000000000000000000000000000000
00d00000000000004777773000000000000047777730000000000000006222222222222222222222222222247777777777777777777737777777777777777777730000000000000000c000c000c000c000c0000000
22222222222250004777773000000000000047777730000000000000004777777777777777777777777777747777777777777777777737777777777777777777730000000001111111111111111111111111111111
77777777777730004777773000000000000047777730000000000000004777777777777777777777777777747777777777777777777737777777777777777777730000000001111111111111111111111111111111
77777777777730004777773000000000000047777730000000000000004777777777777777777777777777747777777777777777777737777777777777777777730000000001111111111111111111111111111111
77777777777730004777773000000000000047777730000000000000004777777777777777777777777777747777777777777777777737777777777777777777730000000001111111111111111111111111111111
77777777777730004777773000000000000047777730000000000000004777777777777777777777777777747777777777777777777737777777777777777777730000000001111111111111111111111111111111
77777777777730004777773000000000000047777730000000000000004777777777777777777777777777747777777777777777777737777777777777777777730000000001111111111111111111111111111111



